region,start time,arch,state,function 1 runtime (ms),function 2 runtime (ms),function 3 runtime (ms),total runtime (ms)
us-east-2,21-12-10 06:11,arm,cold,160789,209896,359898,730583
us-east-2,21-12-10 06:23,arm,cold,161460,213487,358722,733669
us-east-2,21-12-10 06:36,arm,cold,161615,208969,362022,732606
us-east-2,21-12-10 06:48,arm,cold,161693,210365,359569,731627
us-east-2,21-12-10 07:00,arm,cold,161604,212670,358716,732990
us-east-2,21-12-10 07:13,arm,cold,161252,213178,363608,738038
us-east-2,21-12-10 07:25,arm,cold,161215,211735,362760,735710
us-east-2,21-12-10 07:37,arm,cold,161138,210874,367215,739227
us-east-2,21-12-10 07:50,arm,cold,160605,211664,361847,734116
us-east-2,21-12-10 08:02,arm,cold,160291,210405,350937,721633
us-east-2,21-12-10 08:14,arm,cold,160212,214016,365204,739432
us-east-2,21-12-10 08:27,arm,cold,159964,212100,362881,734945
us-east-2,21-12-10 08:39,arm,cold,160585,213295,360377,734257
us-east-2,21-12-10 08:52,arm,cold,161769,213436,362136,737341
us-east-2,21-12-10 09:04,arm,cold,161879,216229,364768,742876
us-east-2,21-12-10 09:17,arm,cold,161045,211745,368216,741006
us-east-2,21-12-10 09:29,arm,cold,160258,211819,360872,732949
us-east-2,21-12-10 09:42,arm,cold,160980,211573,353157,725710
us-east-2,21-12-10 09:54,arm,cold,160343,211829,352683,724855
us-east-2,21-12-10 10:06,arm,cold,160277,213529,357014,730820
us-east-2,21-12-10 10:18,arm,cold,161558,212177,342875,716610
us-east-2,21-12-10 10:30,arm,cold,161348,216073,363166,740587
us-east-2,21-12-10 10:43,arm,cold,160328,210331,356655,727314
us-east-2,21-12-10 11:04,arm,cold,161181,212235,369010,742426
us-east-2,21-12-10 11:17,arm,cold,160915,210922,353576,725413
us-east-2,21-12-10 11:29,arm,cold,161766,211837,348199,721802
us-east-2,21-12-10 11:41,arm,cold,161411,208657,352571,722639
us-east-2,21-12-10 11:53,arm,cold,161354,214769,361715,737838
us-east-2,21-12-10 12:06,arm,cold,161107,208664,351209,720980
us-east-2,21-12-10 12:18,arm,cold,159954,213871,369349,743174
us-east-2,21-12-10 12:31,arm,cold,160447,207914,356629,724990
us-east-2,21-12-10 12:43,arm,cold,160673,210306,363565,734544
us-east-2,21-12-10 12:55,arm,cold,161052,208689,359180,728921
us-east-2,21-12-10 13:08,arm,cold,160762,215351,339651,715764
us-east-2,21-12-10 13:20,arm,cold,161237,215783,364262,741282
us-east-2,21-12-10 13:32,arm,cold,160453,209751,359869,730073
us-east-2,21-12-10 13:44,arm,cold,160224,208814,357209,726247
us-east-2,21-12-10 13:57,arm,cold,161417,211359,359127,731903
us-east-2,21-12-10 14:09,arm,cold,159828,212599,364742,737169
us-east-2,21-12-10 14:21,arm,cold,160547,206163,371139,737849
us-east-2,21-12-10 14:34,arm,cold,161178,210220,371845,743243
us-east-2,21-12-10 14:46,arm,cold,161832,211038,363549,736419
us-east-2,21-12-10 14:59,arm,cold,158689,212088,367783,738560
us-east-2,21-12-10 15:11,arm,cold,161407,214160,354766,730333
us-east-2,21-12-10 15:24,arm,cold,161194,212294,371191,744679
us-east-2,21-12-10 15:36,arm,cold,161281,210270,366443,737994
us-east-2,21-12-10 15:49,arm,cold,162260,213780,359001,735041
us-east-2,21-12-10 16:01,arm,cold,161205,211102,366525,738832
us-east-2,21-12-10 16:13,arm,cold,160286,217952,339346,717584
us-east-2,21-12-10 16:26,arm,cold,162762,214883,351985,729630
us-east-2,21-12-10 16:38,arm,cold,160407,209238,336126,705771
us-east-2,21-12-10 16:50,arm,cold,160988,212872,367066,740926
us-east-2,21-12-10 17:02,arm,cold,160921,210909,351883,723713
us-east-2,21-12-10 17:15,arm,cold,161182,212524,377961,751667
us-east-2,21-12-10 17:27,arm,cold,160940,213588,358925,733453
us-east-2,21-12-10 17:40,arm,cold,160917,214880,350008,725805
us-east-2,21-12-10 17:52,arm,cold,160991,213662,348083,722736
us-east-2,21-12-10 18:04,arm,cold,161250,213309,354037,728596
us-east-2,21-12-10 18:16,arm,cold,162523,212608,358517,733648
us-east-2,21-12-10 18:29,arm,cold,160325,206354,361660,728339
us-east-2,21-12-10 18:41,arm,cold,161607,210798,370017,742422
us-east-2,21-12-10 18:53,arm,cold,160551,210920,360706,732177
us-east-2,21-12-10 19:06,arm,cold,160110,213689,368792,742591
us-east-2,21-12-10 19:18,arm,cold,161295,213047,358961,733303
us-east-2,21-12-10 19:31,arm,cold,161991,209837,366817,738645
us-east-2,21-12-10 19:43,arm,cold,162264,211893,373336,747493
us-east-2,21-12-10 19:56,arm,cold,161390,211607,359090,732087
us-east-2,21-12-10 20:08,arm,cold,159617,212146,367646,739409
us-east-2,21-12-10 20:21,arm,cold,160815,213993,365543,740351
us-east-2,21-12-10 20:33,arm,cold,160114,211901,330500,702515
us-east-2,21-12-10 20:45,arm,cold,160015,206193,356873,723081
us-east-2,21-12-10 20:57,arm,cold,160757,209761,360666,731184
us-east-2,21-12-10 21:10,arm,cold,161668,212149,369788,743605
us-east-2,21-12-10 21:22,arm,cold,160345,211868,353279,725492
us-east-2,21-12-10 21:34,arm,cold,161364,210399,365688,737451
us-east-2,21-12-10 21:47,arm,cold,161072,214000,373857,748929
us-east-2,21-12-10 21:59,arm,cold,160455,212345,355238,728038
us-east-2,21-12-10 22:12,arm,cold,160842,215806,353848,730496
us-east-2,21-12-10 22:24,arm,cold,161304,212933,355478,729715
us-east-2,21-12-10 22:36,arm,cold,161616,208864,355001,725481
us-east-2,21-12-10 22:49,arm,cold,160988,210699,362590,734277
us-east-2,21-12-10 23:01,arm,cold,161569,216723,370440,748732
us-east-2,21-12-10 23:14,arm,cold,161126,212379,364625,738130
us-east-2,21-12-10 23:26,arm,cold,161425,213441,361117,735983
us-east-2,21-12-10 23:38,arm,cold,161183,207339,367972,736494
us-east-2,21-12-10 23:51,arm,cold,161211,212334,365428,738973
us-east-2,21-12-11 00:03,arm,cold,162324,210409,366161,738894
us-east-2,21-12-11 00:16,arm,cold,161902,212285,369744,743931
us-east-2,21-12-11 00:28,arm,cold,159911,206942,357396,724249
us-east-2,21-12-11 00:41,arm,cold,160893,212203,338699,711795
us-east-2,21-12-11 00:53,arm,cold,160812,213131,361918,735861
us-east-2,21-12-11 01:05,arm,cold,161259,212496,356470,730225
us-east-2,21-12-11 01:17,arm,cold,161035,211869,354164,727068
us-east-2,21-12-11 01:30,arm,cold,161487,214348,367775,743610
us-east-2,21-12-11 01:42,arm,cold,161055,211912,359531,732498
us-east-2,21-12-11 01:54,arm,cold,161609,209374,352734,723717
us-east-2,21-12-11 02:07,arm,cold,161942,213319,366148,741409
us-east-2,21-12-11 02:19,arm,cold,160680,207871,368262,736813
us-east-2,21-12-11 02:32,arm,cold,161481,218239,368971,748691
us-east-2,21-12-11 02:44,arm,cold,159682,214746,365457,739885
us-east-2,21-12-11 02:57,arm,cold,162402,210638,367996,741036
us-east-2,21-12-11 03:09,arm,cold,161180,213433,359713,734326
us-east-2,21-12-11 03:22,arm,cold,161085,210842,360867,732794
us-east-2,21-12-11 03:34,arm,cold,161471,214867,353068,729406
us-east-2,21-12-11 03:46,arm,cold,160347,209629,373950,743926
us-east-2,21-12-11 03:59,arm,cold,160703,206157,368496,735356
us-east-2,21-12-11 04:11,arm,cold,162262,213212,358669,734143
us-east-2,21-12-11 04:24,arm,cold,160501,213289,369626,743416
us-east-2,21-12-11 04:36,arm,cold,160988,214199,354979,730166
us-east-2,21-12-11 04:48,arm,cold,161110,212092,357140,730342
us-east-2,21-12-11 05:01,arm,cold,161261,215795,339954,717010
us-east-2,21-12-11 05:13,arm,cold,162246,210382,369533,742161
us-east-2,21-12-11 05:25,arm,cold,161355,211237,365051,737643
us-east-2,21-12-11 05:38,arm,cold,160755,216605,353694,731054
us-east-2,21-12-11 05:50,arm,cold,160896,207887,370121,738904
us-east-2,21-12-11 06:03,arm,cold,160241,214280,367063,741584
us-east-2,21-12-11 06:15,arm,cold,159414,212032,354108,725554
us-east-2,21-12-11 06:27,arm,cold,161373,213660,370222,745255
us-east-2,21-12-11 06:40,arm,cold,161630,212975,340994,715599
us-east-2,21-12-11 06:52,arm,cold,161538,212142,368024,741704
us-east-2,21-12-11 07:05,arm,cold,159987,218297,354528,732812
us-east-2,21-12-11 07:17,arm,cold,161342,211694,372205,745241
us-east-2,21-12-11 07:29,arm,cold,161434,215078,369218,745730
us-east-2,21-12-11 07:42,arm,cold,162373,209753,365431,737557
us-east-2,21-12-11 07:54,arm,cold,161402,212708,360958,735068
us-east-2,21-12-11 08:07,arm,cold,160876,211204,346726,718806
us-east-2,21-12-11 08:19,arm,cold,161184,213030,364845,739059
us-east-2,21-12-11 08:31,arm,cold,160757,210594,358070,729421
us-east-2,21-12-11 08:44,arm,cold,160360,208772,352707,721839
us-east-2,21-12-11 08:56,arm,cold,160589,210607,363261,734457
us-east-2,21-12-11 09:08,arm,cold,161345,210474,367001,738820
us-east-2,21-12-11 09:21,arm,cold,160963,214455,366122,741540
us-east-2,21-12-11 09:33,arm,cold,162386,210183,375538,748107
us-east-2,21-12-11 09:46,arm,cold,160360,212924,363636,736920
us-east-2,21-12-11 09:58,arm,cold,160325,211467,362150,733942
us-east-2,21-12-11 10:11,arm,cold,160232,210951,349368,720551
us-east-2,21-12-11 10:23,arm,cold,161433,212880,338930,713243
us-east-2,21-12-11 10:35,arm,cold,161304,206729,358506,726539
us-east-2,21-12-11 10:47,arm,cold,161831,207495,360959,730285
us-east-2,21-12-11 10:59,arm,cold,161357,209201,372497,743055
us-east-2,21-12-11 11:12,arm,cold,161614,212884,374923,749421
us-east-2,21-12-11 11:25,arm,cold,159263,210340,362362,731965
us-east-2,21-12-11 11:37,arm,cold,161204,207719,340151,709074
us-east-2,21-12-11 11:49,arm,cold,160922,207787,362692,731401
us-east-2,21-12-11 12:01,arm,cold,163459,212354,363077,738890
us-east-2,21-12-11 12:14,arm,cold,161228,210753,367707,739688
us-east-2,21-12-11 12:26,arm,cold,161061,204580,362441,728082
us-east-2,21-12-11 12:39,arm,cold,162200,211761,363114,737075
us-east-2,21-12-11 12:51,arm,cold,161245,209980,360601,731826
us-east-2,21-12-11 13:03,arm,cold,161547,215255,363943,740745
us-east-2,21-12-11 13:16,arm,cold,161638,213503,370567,745708
us-east-2,21-12-11 13:28,arm,cold,161389,208796,364616,734801
us-east-2,21-12-11 13:41,arm,cold,160736,216502,365729,742967
us-east-2,21-12-11 13:53,arm,cold,161211,212355,371081,744647
us-east-2,21-12-11 14:06,arm,cold,161749,212434,375477,749660
us-east-2,21-12-11 14:18,arm,cold,161403,213005,352201,726609
us-east-2,21-12-11 14:31,arm,cold,161881,220125,365102,747108
us-east-2,21-12-11 14:43,arm,cold,160503,212606,348407,721516
us-east-2,21-12-11 14:56,arm,cold,161848,213454,361683,736985
us-east-2,21-12-11 15:08,arm,cold,161179,216769,349244,727192
us-east-2,21-12-11 15:20,arm,cold,161346,213520,322704,697570
us-east-2,21-12-11 15:32,arm,cold,161595,215117,371762,748474
us-east-2,21-12-11 15:45,arm,cold,161054,212947,336901,710902
us-east-2,21-12-11 15:57,arm,cold,161464,212804,367472,741740
us-east-2,21-12-11 16:09,arm,cold,161434,212094,366878,740406
us-east-2,21-12-11 16:22,arm,cold,160125,210369,368028,738522
us-east-2,21-12-11 16:34,arm,cold,160149,208928,361828,730905
us-east-2,21-12-11 16:46,arm,cold,162239,217106,369685,749030
us-east-2,21-12-11 16:59,arm,cold,161918,208739,368451,739108
us-east-2,21-12-11 17:11,arm,cold,162060,213993,357151,733204
us-east-2,21-12-11 17:24,arm,cold,160133,208629,365346,734108
us-east-2,21-12-11 17:36,arm,cold,159413,208686,370872,738971
us-east-2,21-12-11 17:49,arm,cold,160356,212038,360568,732962
us-east-2,21-12-11 18:01,arm,cold,161020,220213,357777,739010
us-east-2,21-12-11 18:14,arm,cold,160393,211395,338487,710275
us-east-2,21-12-11 18:26,arm,cold,162652,210674,353779,727105
us-east-2,21-12-11 18:38,arm,cold,160596,208140,342583,711319
us-east-2,21-12-11 18:50,arm,cold,161147,209715,357380,728242
us-east-2,21-12-11 19:02,arm,cold,160244,210030,358298,728572
us-east-2,21-12-10 06:23,arm,warm,158129,212676,356529,727334
us-east-2,21-12-10 06:48,arm,warm,159061,206130,377611,742802
us-east-2,21-12-10 07:13,arm,warm,159260,214467,375312,749039
us-east-2,21-12-10 07:37,arm,warm,157414,214568,365105,737087
us-east-2,21-12-10 08:02,arm,warm,158548,210475,355853,724876
us-east-2,21-12-10 08:26,arm,warm,158260,211165,381369,750794
us-east-2,21-12-10 08:51,arm,warm,158544,209156,365952,733652
us-east-2,21-12-10 09:16,arm,warm,159203,206657,354776,720636
us-east-2,21-12-10 09:40,arm,warm,158268,211293,365349,734910
us-east-2,21-12-10 10:04,arm,warm,157202,213010,381820,752032
us-east-2,21-12-10 10:29,arm,warm,158141,215953,372278,746372
us-east-2,21-12-10 11:04,arm,warm,158886,209417,353223,721526
us-east-2,21-12-10 11:29,arm,warm,158067,212174,379937,750178
us-east-2,21-12-10 11:54,arm,warm,157710,210165,378057,745932
us-east-2,21-12-10 12:18,arm,warm,158002,209183,380440,747625
us-east-2,21-12-10 12:43,arm,warm,158046,211381,347057,716484
us-east-2,21-12-10 13:20,arm,warm,160928,212170,395202,768300
us-east-2,21-12-10 13:45,arm,warm,159199,212833,380889,752921
us-east-2,21-12-10 14:10,arm,warm,158989,210092,386026,755107
us-east-2,21-12-10 14:36,arm,warm,158503,208504,388045,755052
us-east-2,21-12-10 15:00,arm,warm,158825,209482,369054,737361
us-east-2,21-12-10 15:25,arm,warm,157608,209174,373566,740348
us-east-2,21-12-10 15:49,arm,warm,158445,208115,365644,732204
us-east-2,21-12-10 16:14,arm,warm,158509,208659,376764,743932
us-east-2,21-12-10 16:39,arm,warm,158915,209657,377872,746444
us-east-2,21-12-10 17:03,arm,warm,157550,209394,354915,721859
us-east-2,21-12-10 17:27,arm,warm,160449,204827,349862,715138
us-east-2,21-12-10 17:52,arm,warm,157887,205624,363795,727306
us-east-2,21-12-10 18:16,arm,warm,158192,206792,373643,738627
us-east-2,21-12-10 18:40,arm,warm,159354,206366,368845,734565
us-east-2,21-12-10 19:05,arm,warm,158088,207662,365047,730797
us-east-2,21-12-10 19:42,arm,warm,158996,212433,372296,743725
us-east-2,21-12-10 20:07,arm,warm,158468,210630,372135,741233
us-east-2,21-12-10 20:31,arm,warm,159534,205777,364796,730107
us-east-2,21-12-10 20:56,arm,warm,158459,209422,377593,745474
us-east-2,21-12-10 21:20,arm,warm,159203,207609,360001,726813
us-east-2,21-12-10 21:44,arm,warm,158723,209163,373530,741416
us-east-2,21-12-10 22:09,arm,warm,157790,216217,381299,755306
us-east-2,21-12-10 22:34,arm,warm,158925,206617,374825,740367
us-east-2,21-12-10 22:59,arm,warm,158324,210635,353334,722293
us-east-2,21-12-10 23:23,arm,warm,157076,207405,356096,720577
us-east-2,21-12-10 23:47,arm,warm,159660,210627,352540,722827
us-east-2,21-12-11 00:12,arm,warm,158681,211647,375070,745398
us-east-2,21-12-11 00:36,arm,warm,158513,207153,383875,749541
us-east-2,21-12-11 01:01,arm,warm,163331,213544,382103,758978
us-east-2,21-12-11 01:38,arm,warm,159070,210421,375013,744504
us-east-2,21-12-11 02:03,arm,warm,159432,210732,375270,745434
us-east-2,21-12-11 02:28,arm,warm,157924,205175,360802,723901
us-east-2,21-12-11 02:52,arm,warm,159516,211778,361927,733221
us-east-2,21-12-11 03:16,arm,warm,158379,210240,376217,744836
us-east-2,21-12-11 03:41,arm,warm,158936,210382,368456,737774
us-east-2,21-12-11 04:06,arm,warm,159065,206309,364669,730043
us-east-2,21-12-11 04:30,arm,warm,158523,207658,367699,733880
us-east-2,21-12-11 04:55,arm,warm,158365,210643,377062,746070
us-east-2,21-12-11 05:31,arm,warm,158521,210556,372359,741436
us-east-2,21-12-11 05:55,arm,warm,158211,203908,364471,726590
us-east-2,21-12-11 06:20,arm,warm,158509,206354,351653,716516
us-east-2,21-12-11 06:44,arm,warm,158314,209132,382918,750364
us-east-2,21-12-11 07:09,arm,warm,159574,212930,382590,755094
us-east-2,21-12-11 07:34,arm,warm,161424,211992,367862,741278
us-east-2,21-12-11 07:58,arm,warm,158673,211717,375105,745495
us-east-2,21-12-11 08:23,arm,warm,158635,211114,389999,759748
us-east-2,21-12-11 08:48,arm,warm,159062,210537,380372,749971
us-east-2,21-12-11 09:13,arm,warm,158472,212608,379060,750140
us-east-2,21-12-11 09:51,arm,warm,159728,217138,386776,763642
us-east-2,21-12-11 10:16,arm,warm,158726,209897,379746,748369
us-east-2,21-12-11 10:41,arm,warm,159344,205483,377954,742781
us-east-2,21-12-11 11:06,arm,warm,158238,208992,368670,735900
us-east-2,21-12-11 11:43,arm,warm,157796,210710,364682,733188
us-east-2,21-12-11 12:07,arm,warm,158950,206860,376243,742053
us-east-2,21-12-11 12:32,arm,warm,157895,211965,375408,745268
us-east-2,21-12-11 12:56,arm,warm,157945,209987,354418,722350
us-east-2,21-12-11 13:21,arm,warm,158960,213318,376964,749242
us-east-2,21-12-11 13:46,arm,warm,160485,216309,378204,754998
us-east-2,21-12-11 14:10,arm,warm,159993,212304,375226,747523
us-east-2,21-12-11 14:35,arm,warm,159045,208488,365557,733090
us-east-2,21-12-11 15:00,arm,warm,158501,206658,372919,738078
us-east-2,21-12-11 15:25,arm,warm,158944,213621,379847,752412
us-east-2,21-12-11 15:50,arm,warm,158667,209721,356494,724882
us-east-2,21-12-11 16:14,arm,warm,159150,209714,360037,728901
us-east-2,21-12-11 16:39,arm,warm,158488,208891,373345,740724
us-east-2,21-12-11 17:03,arm,warm,157583,210713,367526,735822
us-east-2,21-12-11 17:40,arm,warm,159939,208331,365111,733381
us-east-2,21-12-11 18:04,arm,warm,158675,208817,379388,746880
us-east-2,21-12-11 18:29,arm,warm,158403,207989,378634,745026
us-east-2,21-12-11 18:54,arm,warm,158223,210304,347175,715702
us-east-2,21-12-10 06:11,x86,cold,179715,175030,393077,747822
us-east-2,21-12-10 06:23,x86,cold,180004,175502,371065,726571
us-east-2,21-12-10 06:36,x86,cold,178673,170875,374614,724162
us-east-2,21-12-10 06:48,x86,cold,183545,172682,376676,732903
us-east-2,21-12-10 07:00,x86,cold,178433,179291,382719,740443
us-east-2,21-12-10 07:13,x86,cold,178389,174077,377468,729934
us-east-2,21-12-10 07:25,x86,cold,177653,178711,422782,779146
us-east-2,21-12-10 07:38,x86,cold,179405,171558,336949,687912
us-east-2,21-12-10 07:50,x86,cold,175786,178244,465116,819146
us-east-2,21-12-10 08:04,x86,cold,178053,178141,377462,733656
us-east-2,21-12-10 08:16,x86,cold,183410,175977,361563,720950
us-east-2,21-12-10 08:28,x86,cold,182861,178751,506561,868173
us-east-2,21-12-10 08:43,x86,cold,181262,180142,386956,748360
us-east-2,21-12-10 08:56,x86,cold,173534,178672,379611,731817
us-east-2,21-12-10 09:08,x86,cold,181523,175110,377987,734620
us-east-2,21-12-10 09:20,x86,cold,183729,177179,394085,754993
us-east-2,21-12-10 09:33,x86,cold,181661,172789,423509,777959
us-east-2,21-12-10 09:46,x86,cold,184393,179895,421028,785316
us-east-2,21-12-10 09:59,x86,cold,183432,178292,478989,840713
us-east-2,21-12-10 10:14,x86,cold,179423,174488,386993,740904
us-east-2,21-12-10 10:26,x86,cold,176611,176750,363595,716956
us-east-2,21-12-10 10:38,x86,cold,179222,179642,373331,732195
us-east-2,21-12-10 11:19,x86,cold,182186,177633,384298,744117
us-east-2,21-12-10 11:32,x86,cold,179326,181347,379978,740651
us-east-2,21-12-10 11:44,x86,cold,181182,175643,392712,749537
us-east-2,21-12-10 11:57,x86,cold,180405,177066,400542,758013
us-east-2,21-12-10 12:10,x86,cold,180618,175692,385535,741845
us-east-2,21-12-10 12:22,x86,cold,181686,173435,387691,742812
us-east-2,21-12-10 12:35,x86,cold,181323,179538,374532,735393
us-east-2,21-12-10 12:47,x86,cold,180498,173799,409124,763421
us-east-2,21-12-10 13:00,x86,cold,180483,175321,371692,727496
us-east-2,21-12-10 13:12,x86,cold,181664,179510,444775,805949
us-east-2,21-12-10 13:26,x86,cold,181586,176066,392456,750108
us-east-2,21-12-10 13:39,x86,cold,181412,170563,368215,720190
us-east-2,21-12-10 13:51,x86,cold,181698,176868,387670,746236
us-east-2,21-12-10 14:03,x86,cold,177680,182388,375789,735857
us-east-2,21-12-10 14:16,x86,cold,177855,177256,365231,720342
us-east-2,21-12-10 14:28,x86,cold,180502,175100,390763,746365
us-east-2,21-12-10 14:41,x86,cold,180165,176835,385232,742232
us-east-2,21-12-10 14:53,x86,cold,182342,174650,387127,744119
us-east-2,21-12-10 15:06,x86,cold,182098,178074,385889,746061
us-east-2,21-12-10 15:18,x86,cold,181510,177282,366855,725647
us-east-2,21-12-10 15:31,x86,cold,177205,178970,378368,734543
us-east-2,21-12-10 15:43,x86,cold,180502,179650,393597,753749
us-east-2,21-12-10 15:56,x86,cold,180782,175672,421232,777686
us-east-2,21-12-10 16:09,x86,cold,178065,178608,414973,771646
us-east-2,21-12-10 16:22,x86,cold,181419,175254,444988,801661
us-east-2,21-12-10 16:35,x86,cold,180357,174339,383986,738682
us-east-2,21-12-10 16:48,x86,cold,179140,177209,394246,750595
us-east-2,21-12-10 17:00,x86,cold,181821,177747,379388,738956
us-east-2,21-12-10 17:13,x86,cold,179672,177354,357748,714774
us-east-2,21-12-10 17:25,x86,cold,183277,176864,466094,826235
us-east-2,21-12-10 17:39,x86,cold,179639,180760,389188,749587
us-east-2,21-12-10 17:52,x86,cold,179513,177248,430079,786840
us-east-2,21-12-10 18:05,x86,cold,180920,180252,407369,768541
us-east-2,21-12-10 18:18,x86,cold,182180,175451,402164,759795
us-east-2,21-12-10 18:31,x86,cold,179709,178900,349753,708362
us-east-2,21-12-10 18:43,x86,cold,179687,173604,391998,745289
us-east-2,21-12-10 18:55,x86,cold,182847,180153,564975,927975
us-east-2,21-12-10 19:11,x86,cold,180902,173942,381810,736654
us-east-2,21-12-10 19:23,x86,cold,189089,175849,384418,749356
us-east-2,21-12-10 19:36,x86,cold,178819,179705,390480,749004
us-east-2,21-12-10 19:49,x86,cold,180576,177827,384806,743209
us-east-2,21-12-10 20:01,x86,cold,179148,174259,397839,751246
us-east-2,21-12-10 20:14,x86,cold,179191,179839,388484,747514
us-east-2,21-12-10 20:26,x86,cold,182101,178113,408900,769114
us-east-2,21-12-10 20:39,x86,cold,182508,178495,375845,736848
us-east-2,21-12-10 20:52,x86,cold,183967,175877,388697,748541
us-east-2,21-12-10 21:05,x86,cold,189115,182746,389606,761467
us-east-2,21-12-10 21:17,x86,cold,182472,179592,503722,865786
us-east-2,21-12-10 21:32,x86,cold,180973,182955,387591,751519
us-east-2,21-12-10 21:45,x86,cold,179878,180360,464452,824690
us-east-2,21-12-10 21:59,x86,cold,181501,173892,386717,742110
us-east-2,21-12-10 22:11,x86,cold,181894,179954,393725,755573
us-east-2,21-12-10 22:24,x86,cold,180738,181585,468829,831152
us-east-2,21-12-10 22:38,x86,cold,180361,191087,467633,839081
us-east-2,21-12-10 22:52,x86,cold,183470,175339,392067,750876
us-east-2,21-12-10 23:05,x86,cold,182775,175858,415724,774357
us-east-2,21-12-10 23:18,x86,cold,185515,173730,405858,765103
us-east-2,21-12-10 23:31,x86,cold,180981,179675,449084,809740
us-east-2,21-12-10 23:44,x86,cold,180189,177880,397547,755616
us-east-2,21-12-10 23:57,x86,cold,176887,180082,452329,809298
us-east-2,21-12-11 00:11,x86,cold,178453,176926,390297,745676
us-east-2,21-12-11 00:23,x86,cold,180978,176295,439999,797272
us-east-2,21-12-11 00:37,x86,cold,179983,177214,379727,736924
us-east-2,21-12-11 00:49,x86,cold,182591,174879,462594,820064
us-east-2,21-12-11 01:03,x86,cold,181265,175656,382268,739189
us-east-2,21-12-11 01:16,x86,cold,184728,176296,396866,757890
us-east-2,21-12-11 01:28,x86,cold,179233,176480,365544,721257
us-east-2,21-12-11 01:40,x86,cold,177529,175048,345984,698561
us-east-2,21-12-11 01:52,x86,cold,177762,181046,369788,728596
us-east-2,21-12-11 02:05,x86,cold,178441,174825,363482,716748
us-east-2,21-12-11 02:17,x86,cold,181027,186983,365474,733484
us-east-2,21-12-11 02:29,x86,cold,180893,174841,369351,725085
us-east-2,21-12-11 02:41,x86,cold,178337,176280,373451,728068
us-east-2,21-12-11 02:54,x86,cold,174218,169285,381323,724826
us-east-2,21-12-11 03:06,x86,cold,177976,175870,392772,746618
us-east-2,21-12-11 03:18,x86,cold,175117,176398,350091,701606
us-east-2,21-12-11 03:30,x86,cold,175921,176397,371882,724200
us-east-2,21-12-11 03:42,x86,cold,177035,175264,447764,800063
us-east-2,21-12-11 03:56,x86,cold,179361,174626,395008,748995
us-east-2,21-12-11 04:09,x86,cold,178534,178843,347145,704522
us-east-2,21-12-11 04:21,x86,cold,179470,180357,381540,741367
us-east-2,21-12-11 04:33,x86,cold,182809,176010,393795,752614
us-east-2,21-12-11 04:46,x86,cold,180471,175361,398623,754455
us-east-2,21-12-11 04:58,x86,cold,180227,176577,382939,739743
us-east-2,21-12-11 05:11,x86,cold,182274,175250,355739,713263
us-east-2,21-12-11 05:23,x86,cold,178281,176592,397588,752461
us-east-2,21-12-11 05:36,x86,cold,179627,178134,375594,733355
us-east-2,21-12-11 05:48,x86,cold,179807,179869,360009,719685
us-east-2,21-12-11 06:00,x86,cold,179704,175228,391080,746012
us-east-2,21-12-11 06:13,x86,cold,180467,172895,351608,704970
us-east-2,21-12-11 06:25,x86,cold,180025,176881,358545,715451
us-east-2,21-12-11 06:37,x86,cold,182634,176508,339802,698944
us-east-2,21-12-11 06:49,x86,cold,179389,177126,381650,738165
us-east-2,21-12-11 07:01,x86,cold,183949,175386,334465,693800
us-east-2,21-12-11 07:13,x86,cold,179530,176822,390923,747275
us-east-2,21-12-11 07:25,x86,cold,177140,176156,377581,730877
us-east-2,21-12-11 07:38,x86,cold,179787,176646,380480,736913
us-east-2,21-12-11 07:50,x86,cold,180252,173366,368628,722246
us-east-2,21-12-11 08:02,x86,cold,179413,176901,356627,712941
us-east-2,21-12-11 08:14,x86,cold,184570,179785,362808,727163
us-east-2,21-12-11 08:27,x86,cold,178498,172704,454582,805784
us-east-2,21-12-11 08:40,x86,cold,177180,178952,378810,734942
us-east-2,21-12-11 08:53,x86,cold,180737,173583,366250,720570
us-east-2,21-12-11 09:05,x86,cold,179780,176664,425715,782159
us-east-2,21-12-11 09:18,x86,cold,184739,180733,380045,745517
us-east-2,21-12-11 09:31,x86,cold,181723,182417,390797,754937
us-east-2,21-12-11 09:43,x86,cold,183159,175654,504572,863385
us-east-2,21-12-11 09:58,x86,cold,183289,176752,378235,738276
us-east-2,21-12-11 10:10,x86,cold,182528,182545,360253,725326
us-east-2,21-12-11 10:23,x86,cold,180030,178093,394293,752416
us-east-2,21-12-11 10:35,x86,cold,179031,172945,363235,715211
us-east-2,21-12-11 10:47,x86,cold,181706,175362,469986,827054
us-east-2,21-12-11 11:01,x86,cold,182815,179180,402470,764465
us-east-2,21-12-11 11:14,x86,cold,182683,178510,466506,827699
us-east-2,21-12-11 11:28,x86,cold,180115,178085,466672,824872
us-east-2,21-12-11 11:42,x86,cold,183725,182237,403646,769608
us-east-2,21-12-11 11:55,x86,cold,180258,172999,400533,753790
us-east-2,21-12-11 12:08,x86,cold,181821,179294,362238,723353
us-east-2,21-12-11 12:20,x86,cold,178165,176855,346592,701612
us-east-2,21-12-11 12:32,x86,cold,179271,176128,383037,738436
us-east-2,21-12-11 12:44,x86,cold,180489,175570,388941,745000
us-east-2,21-12-11 12:57,x86,cold,182569,178083,483192,843844
us-east-2,21-12-11 13:11,x86,cold,180333,176980,506546,863859
us-east-2,21-12-11 13:26,x86,cold,182659,179575,376615,738849
us-east-2,21-12-11 13:38,x86,cold,179147,180609,363775,723531
us-east-2,21-12-11 13:50,x86,cold,177955,178111,365163,721229
us-east-2,21-12-11 14:03,x86,cold,180483,170599,389290,740372
us-east-2,21-12-11 14:15,x86,cold,184646,178892,370591,734129
us-east-2,21-12-11 14:27,x86,cold,181702,180299,403124,765125
us-east-2,21-12-11 14:40,x86,cold,183284,175965,506484,865733
us-east-2,21-12-11 14:55,x86,cold,183040,183752,474726,841518
us-east-2,21-12-11 15:09,x86,cold,186778,181301,491800,859879
us-east-2,21-12-11 15:24,x86,cold,189676,196830,458131,844637
us-east-2,21-12-11 15:38,x86,cold,211495,176500,404860,792855
us-east-2,21-12-11 15:51,x86,cold,182621,179338,400180,762139
us-east-2,21-12-11 16:04,x86,cold,179317,179102,397366,755785
us-east-2,21-12-11 16:17,x86,cold,180295,178103,391824,750222
us-east-2,21-12-11 16:30,x86,cold,180200,178387,392307,750894
us-east-2,21-12-11 16:42,x86,cold,177838,191657,450224,819719
us-east-2,21-12-11 16:56,x86,cold,179329,174080,400523,753932
us-east-2,21-12-11 17:09,x86,cold,177370,175543,402714,755627
us-east-2,21-12-11 17:22,x86,cold,179659,179724,389842,749225
us-east-2,21-12-11 17:34,x86,cold,178067,178198,377085,733350
us-east-2,21-12-11 17:47,x86,cold,179662,178819,466137,824618
us-east-2,21-12-11 18:01,x86,cold,184349,184806,384349,753504
us-east-2,21-12-11 18:13,x86,cold,184588,181752,399577,765917
us-east-2,21-12-11 18:26,x86,cold,178331,177638,418954,774923
us-east-2,21-12-11 18:39,x86,cold,184244,174533,369323,728100
us-east-2,21-12-11 18:52,x86,cold,181127,171607,382211,734945
us-east-2,21-12-11 19:04,x86,cold,180902,185345,425894,792141
us-east-2,21-12-10 06:23,x86,warm,175567,180475,380085,736127
us-east-2,21-12-10 06:47,x86,warm,175153,175856,371854,722863
us-east-2,21-12-10 07:12,x86,warm,176974,177337,450900,805211
us-east-2,21-12-10 07:39,x86,warm,183162,176175,495475,854812
us-east-2,21-12-10 08:20,x86,warm,176637,172187,471252,820076
us-east-2,21-12-10 08:47,x86,warm,178459,171875,389127,739461
us-east-2,21-12-10 09:12,x86,warm,179055,180329,403217,762601
us-east-2,21-12-10 09:37,x86,warm,177189,173315,402431,752935
us-east-2,21-12-10 10:03,x86,warm,182117,177071,424895,784083
us-east-2,21-12-10 10:29,x86,warm,178572,176007,400320,754899
us-east-2,21-12-10 11:04,x86,warm,190066,178975,486221,855262
us-east-2,21-12-10 11:31,x86,warm,179969,176316,402161,758446
us-east-2,21-12-10 11:57,x86,warm,178599,174976,426702,780277
us-east-2,21-12-10 12:23,x86,warm,179967,173964,401774,755705
us-east-2,21-12-10 12:48,x86,warm,175911,173281,410392,759584
us-east-2,21-12-10 13:13,x86,warm,180149,175936,382516,738601
us-east-2,21-12-10 13:38,x86,warm,178966,173444,419309,771719
us-east-2,21-12-10 14:03,x86,warm,174803,181090,410716,766609
us-east-2,21-12-10 14:29,x86,warm,180412,177985,396396,754793
us-east-2,21-12-10 14:54,x86,warm,177626,181811,406470,765907
us-east-2,21-12-10 15:20,x86,warm,177573,172237,385053,734863
us-east-2,21-12-10 15:57,x86,warm,179263,174811,403959,758033
us-east-2,21-12-10 16:22,x86,warm,179388,170817,448464,798669
us-east-2,21-12-10 16:49,x86,warm,178565,173427,481506,833498
us-east-2,21-12-10 17:17,x86,warm,185093,173114,472604,830811
us-east-2,21-12-10 17:44,x86,warm,179777,174571,467139,821487
us-east-2,21-12-10 18:11,x86,warm,180757,173091,403321,757169
us-east-2,21-12-10 18:36,x86,warm,179529,176931,426568,783028
us-east-2,21-12-10 19:03,x86,warm,185710,179991,518825,884526
us-east-2,21-12-10 19:32,x86,warm,182524,175548,457639,815711
us-east-2,21-12-10 19:59,x86,warm,179071,177473,460627,817171
us-east-2,21-12-10 20:25,x86,warm,176803,176323,406782,759908
us-east-2,21-12-10 20:51,x86,warm,180520,176519,408694,765733
us-east-2,21-12-10 21:16,x86,warm,182762,177066,428968,788796
us-east-2,21-12-10 21:42,x86,warm,182001,173139,413169,768309
us-east-2,21-12-10 22:08,x86,warm,180211,169989,426026,776226
us-east-2,21-12-10 22:34,x86,warm,180351,177553,393192,751096
us-east-2,21-12-10 22:59,x86,warm,178565,171763,397060,747388
us-east-2,21-12-10 23:24,x86,warm,178835,177353,364216,720404
us-east-2,21-12-10 23:48,x86,warm,183163,176182,356967,716312
us-east-2,21-12-11 00:12,x86,warm,182746,178499,380951,742196
us-east-2,21-12-11 00:37,x86,warm,182190,177537,386855,746582
us-east-2,21-12-11 01:02,x86,warm,178126,170795,374293,723214
us-east-2,21-12-11 01:26,x86,warm,176683,177244,408583,762510
us-east-2,21-12-11 01:52,x86,warm,182360,177084,402019,761463
us-east-2,21-12-11 02:17,x86,warm,177492,175040,393561,746093
us-east-2,21-12-11 02:42,x86,warm,178148,175848,411216,765212
us-east-2,21-12-11 03:08,x86,warm,177773,174744,389509,742026
us-east-2,21-12-11 03:32,x86,warm,178767,169709,403234,751710
us-east-2,21-12-11 03:58,x86,warm,176545,176361,410558,763464
us-east-2,21-12-11 04:23,x86,warm,173923,169895,398944,742762
us-east-2,21-12-11 04:48,x86,warm,176330,170994,400336,747660
us-east-2,21-12-11 05:13,x86,warm,177150,178447,380834,736431
us-east-2,21-12-11 05:37,x86,warm,182599,174404,381711,738714
us-east-2,21-12-11 06:02,x86,warm,178483,174618,388194,741295
us-east-2,21-12-11 06:27,x86,warm,177565,172560,368913,719038
us-east-2,21-12-11 07:03,x86,warm,180044,173184,387368,740596
us-east-2,21-12-11 07:28,x86,warm,174813,175055,365438,715306
us-east-2,21-12-11 07:52,x86,warm,176194,176775,387040,740009
us-east-2,21-12-11 08:18,x86,warm,183029,179796,460346,823171
us-east-2,21-12-11 08:44,x86,warm,181682,179571,395234,756487
us-east-2,21-12-11 09:11,x86,warm,180838,176815,469434,827087
us-east-2,21-12-11 09:38,x86,warm,185202,178436,490468,854106
us-east-2,21-12-11 10:06,x86,warm,178605,176781,468746,824132
us-east-2,21-12-11 10:47,x86,warm,181530,182417,459242,823189
us-east-2,21-12-11 11:14,x86,warm,178808,175921,439222,793951
us-east-2,21-12-11 11:40,x86,warm,179102,175617,451436,806155
us-east-2,21-12-11 12:07,x86,warm,183250,174915,457808,815973
us-east-2,21-12-11 12:34,x86,warm,182598,179667,458948,821213
us-east-2,21-12-11 13:02,x86,warm,181550,181516,514915,877981
us-east-2,21-12-11 13:30,x86,warm,179724,174535,378154,732413
us-east-2,21-12-11 13:55,x86,warm,179735,174864,389672,744271
us-east-2,21-12-11 14:33,x86,warm,180361,175845,416350,772556
us-east-2,21-12-11 15:00,x86,warm,200778,212762,588206,1001746
us-east-2,21-12-11 15:32,x86,warm,191575,180129,527870,899574
us-east-2,21-12-11 16:00,x86,warm,175454,180487,382662,738603
us-east-2,21-12-11 16:26,x86,warm,181140,178226,464382,823748
us-east-2,21-12-11 16:54,x86,warm,180019,182168,503120,865307
us-east-2,21-12-11 17:22,x86,warm,177291,173188,438577,789056
us-east-2,21-12-11 18:02,x86,warm,178327,175238,453265,806830
us-east-2,21-12-11 18:27,x86,warm,174928,177266,366203,718397
us-east-2,21-12-11 18:52,x86,warm,174064,176326,384863,735253
